================== =========
= B                = P B   =
=====H====H   B    =======H=
=====H============== ===  H=
=    H  B P     ==== ===  H=
=H=========H======== ===  H=
=H   ======H=====BB= ===B H=
=H   ======H==============H=
=H   =    BH    B  P   B =H=
=H   ===H=======H=======H=H=
=H  B===H       H=======H=H=
=H====  H    R  H  ==   H=H=
=H====H=====H========BB H=H=
=H====H=====H======B======H=
=HP   H==B==H    B  P     H=
============================
